Всероссийский научно-исследовательский институт автоматики им. H.Л.Духова	Москва	vniia.ru
Горно-химический комбинат	Красноярский край	sibghk.ru
Комбинат "Электрохимприбор"	Свердловская область	ehp-atom.ru
Научно-исследовательский технологический институт имени А.П.Александрова	Ленинградская область	niti.ru
Приборостроительный завод	Челябинская область	imf.ru
Производственное объединение "Маяк"	Челябинская областвь	po-mayak.ru
Российский Федеральный Ядерный Центр - Всероссийский научно-исследовательский институт технической физики имени академика Е.И.Забабахина	Челябинская область	vniitf.ru
Российский федеральный ядерный центр - Всероссийский научно-исследовательский институт экспериментальной физики	Нижегородская область	vniief.ru
Федеральное государственное унитарное предприятие атомного флота	Мурманская область	rosatomflot.ru
Ивановский научно-исследовательский институт пленочных материалов и искусственной кожи технического назначения Федеральной службы безопасности Российской Федерации	Ивановская область	vniipik.ru
"Комплекс" Федеральной службы безопасности Российской Федерации	Москва	complexmsk.ru
Научно-исследовательский институт "Квант"	Москва	rdi-kvant.ru
Научно-технический центр "Базис" Федеральной службы безопасности Российской Федерации	Калужская область	ntcbazis.ru
"Научно-технический центр "Орион" Федеральной службы безопасности Российской Федерации	Москва	fgupntcorion.ru
Ростовский-на-Дону научно-исследовательский институт радиосвязи	Ростовская область	rniirs.ru
Смоленское производственное объединение "Аналитприбор"	Смоленская область	analitpribor-smolensk.ru
"Научно-технический центр правовой информации "Система" Федеральной службы охраны Российской Федерации	Москва	systema.ru
СВЭКО	Москва	svecko.ru
Всероссийская государственная телевизионная и радиовещательная компания	Москва	vgtrk.com
Главный радиочастотный центр	Москва	grfc.ru
Информационное телеграфное агентство России (ИТАР-ТАСС)	Москва	tass.ru
Космическая связь	Москва	rscc.ru
Международное информационное агентство "Россия сегодня"	Москва	россиясегодня.рф
Радиочастотный центр Центрального федерального округа	Москва	grfc.ru
Российская телевизионная и радиовещательная сеть	Москва	rtrs.ru
Телевизионный технический центр "Останкино"	Москва	ostankino.ru
13 судоремонтный завод Черноморского флота Министерства обороны Российской Федерации	Севастополь	13srz.ru
"102 Предприятие электрических сетей" Министерства обороны Российской Федерации	Севастополь	102пэс.рф
"Дирекция по сохранению объектов культурного наследия" Министерства обороны Российской Федерации	Москва	dsokn.ru
Издательство и типография газеты "Страж Балтики" Министерства обороны Российской Федерации	Калининградская область	стражбалтики.рф
"Оборонпромэкология" Министерства обороны Российской Федерации	Москва	oboronpromecologiya.ru
"Спецстройсервис" при Федеральном агентстве специального строительства	Москва	gvsu-12.ru›personal.html
"Главный научно-исследовательский вычислительный центр" Управления делами Президента Российской Федерации	Москва	grcc.ru
"Книжная экспедиция" Управления делами Президента Российской Федерации	Москва	kremlin-symbol.ru
Предприятие по поставкам продукции Управления делами Президента Российской Федерации	Москва	pppudp.ru
"Президент-Сервис" Управления делами Президента Российской Федерации	Москва	prsr.ru
"Ремонтно-строительное управление" Управления делами Президента Российской Федерации	Москва	rsurf.ru
"Торговый дом "Кремлевский" Управления делами Президента Российской Федерации	Москва	tdkremlin.ru
Главное производственно-коммерческое управление по обслуживанию дипломатического корпуса при Министерстве иностранных дел Российской Федерации	Москва	updk.ru
Федеральное государственное унитарное предприятие "Государственный трест "Арктикуголь"	Москва	arcticugol.ru
Федеральное государственное унитарное предприятие "Внешнеэкономическое объединение "Промсырьеимпорт" Министерства энергетики Российской Федерации	Москва	vopromsi.ru
Центральный ордена Трудового Красного Знамени научно-исследовательский автомобильный и автомоторный институт "НАМИ"	Москва	nami.ru
Российская государственная цирковая компания	Москва	circus.ru
"Киноконцерн "Мосфильм"	Москва	mosfilm.ru
Большой Московский государственный цирк на проспекте Вернадского	Москва	greatcircus.ru
Московский эндокринный завод	Москва	endopharm.ru
Крыловский государственный научный центр	Санкт-Петербург	krylov-centre.ru
Всероссийский научно-исследовательский институт авиационных материалов	Москва	viam.ru
Государственный научно-исследовательский институт органической химии и технологии	Москва	gosniiokht.ru
"Федеральный научно-производственный центр "Прогресс"	Омская область	progress-omsk.ru
"Научно-технический центр оборонного комплекса "Компас"	Москва	ntckompas.ru
"Научно-производственное предприятие "Гамма"	Москва	nppgamma.ru
Центральный аэрогидродинамический институт имени профессора Н.Е.Жуковского	Московская область	tsagi.ru
Центральный институт авиационного моторостроения имени П.И.Баранова	Москва	ciam.ru
Государственный научно-исследовательский институт авиационных систем	Москва	gosniias.ru
"Научно-производственное объединение по медицинским иммунобиологическим препаратам "Микроген" Министерства здравоохранения Российской Федерации	Москва	microgen.ru
Государственный космический научно-производственный центр имени М.В.Хруничева	Москва	khrunichev.ru
Научно-исследовательский институт машиностроения	Свердловская область	tsniimash.ru
"Московское опытно-конструкторское бюро "Марс"	Москва	mokb-mars.ru
"Опытное конструкторское бюро "Факел"	Калининградская область	fakel-russia.com
"Научно-производственное объединение "Техномаш"	Москва	tmnpo.ru›node
Государственный научный центр Российской Федерации - федеральное государственное унитарное предприятие "Исследовательский центр имени М.В.Келдыша"	Москва	kerc.msk.ru
Научно-производственный центр автоматики и приборостроения имени академика Н.А.Пилюгина	Москва	npcap.ru
"Организация "Агат"	Москва	agat-roscosmos.ru
Центральный научно-исследовательский институт машиностроения	Московская область	sniimash.ru
Центр эксплуатации объектов наземной космической инфраструктуры	Москва	russian.space
"Научно-технический центр "Заря"	Москва	ntc-zarya.ru
Центр "Звездный"	Москва	zvezdnyj.ru
Государственный научно-исследовательский институт прикладных проблем	Санкт-Петербург	gosniipp.ru
Научно-исследовательский институт прикладной акустики	Московская область	niipa.ru
"Научный центр "Сигнал"	Москва	ncsignal.ru
"Производственное объединение "Октябрь"	Свердловская область	neywa.ru
Центральный научно-исследовательский институт химии и механики	Москва	cniihm.ru
"Государственное научно-производственное предприятие "Крона"	Владимирская область  	fgupkrona.ru
"Научно-исследовательский институт Научно-производственное объединение "ЛУЧ"	Московская область	luch-atomterm.ru
"Научно-технический центр "Атлас"	Москва	stcnet.ru
Управление строительства N 30	Республика Башкортостан	us30.ru
Дирекция единого заказчика	Москва	gup-dez.ru
Ордена Трудового Красного Знамени научно-исследовательский институт радио	Москва	niir.ru
Почта России	Москва	pochta.ru
Почта Крыма	Крым	crimea-post.ru
Росморпорт	Москва	rosmorport.ru
Морсвязьспутник	Москва	marsat.ru
Федеральное государственное унитарное гидрографическое предприятие	Санкт-Петербург	hydro-state.ru
Федеральное государственное унитарное предприятие "Управление ведомственной охраны Министерства транспорта Российской Федерации"	Москва	uvomintrans.ru
Авиакомплект	Москва	aviacomplect.com
